A minature meteorite just collided with the east wing! There's a major fracture in the wall as well as several malfunctions in the oxygenating system. The east wing has been temporarily sealed off, but you must repair it or all the oxygen will escape.

Oxygen Breach
An Interactive Fiction by tendo19
Release 1 / Serial number 190304 / Inform 7 build 6M62 (I6/v6.33 lib 6/12N) SD

Control Center
There's a control panel alongside the wall. It controls everything that occurs in the space station. The main room is to the south.

You can see Commander and a control panel here.

>e
You can't go that way.

>s
Main Room
This is the largest room in the station. There is one room to the west and the utility room is to the south. There is a leak in the east wing, so enter with caution.

You can see Aerospace Engineer, a warning sign and a picture frame here.

>e
Are you sure you want to enter?

>no
After using good judgement, you determine that it's not safe to enter a room with no oxygen.

>e
Are you sure you want to enter?

>yes
    *** You gasp for air. The door behind you closes. You die from hypoxia. ***

Would you like to RESTART, RESTORE a saved game, QUIT or UNDO the last command?

>restart
A minature meteorite just collided with the east wing! There's a major fracture in the wall as well as several malfunctions in the oxygenating system. The east wing has been temporarily sealed off, but you must repair it or all the oxygen will escape.

Oxygen Breach
An Interactive Fiction by tendo19
Release 1 / Serial number 190303 / Inform 7 build 6M62 (I6/v6.33 lib 6/12N) SD

Control Center
There's a control panel alongside the wall. It controls everything that occurs in the space station. The main room is to the south.

You can see Commander and a control panel here.

>s
Main Room
This is the largest room in the station. There is one room to the west and the utility room is to the south. There is a leak in the east wing, so enter with caution.

You can see Aerospace Engineer, a warning sign and a picture frame here.

>n
Control Center
There's a control panel alongside the wall. It controls everything that occurs in the space station. The main room is to the south.

You can see Commander and a control panel here.

>x control panel
You see knobs, buttons, screens, and a bunch of flickering lights. You aren't sure what anything does.

>push button
you pushed the button and heard a click.

>s
Main Room
This is the largest room in the station. There is one room to the west and the utility room is to the south. There is a leak in the east wing, so enter with caution.

You can see Aerospace Engineer, a warning sign and a picture frame here.

* * *

>no
After using good judgement, you determine that it's not safe to enter a room with no oxygen.

>w
West Wing
There is nothing much here ... except the commander's locker. Perhaps you should take a closer look at it. The main room is to the east.

You can see a locker (closed) here.

>unlock locker
(with the locker)
(first taking the locker)
That's fixed in place.

>x locker
This is the commander's locker. Enter the six-digit pin code to unlock it.

Please enter the six-digit locker pin code.

>112098
**BUZZ**  Access granted

>open locker
You open the locker, revealing Bolts, Duct tape and Astronaut suit.

>take bolts
Taken.

>take duct tape
Taken.

>take astronaut suit
Taken.

>wear astronaut suit
You put on Astronaut suit.

>e
Main Room
This is the largest room in the station. There is one room to the west and the utility room is to the south. There is a leak in the east wing, so enter with caution.

You can see Aerospace Engineer, a warning sign and a picture frame here.

>e
Are you sure you want to enter?

>yes
There is a crack on the wall and the oxygenation tank has malfunctioned. There's a metal panel on the floor that should be on the tank. The oxygen level is critical. Repair the damage immediately!

>x wall
You can't see any such thing.

* * *

A minature meteorite just collided with the east wing! There's a major fracture in the wall as well as several malfunctions in the oxygenating system. The east wing has been temporarily sealed off, but you must repair it or all the oxygen will escape.

Oxygen Breach
An Interactive Fiction by tendo19
Release 1 / Serial number 190304 / Inform 7 build 6M62 (I6/v6.33 lib 6/12N) SD

Control Center
There's a control panel alongside the wall. It controls everything that occurs in the space station. The main room is to the south.

You can see Commander and a control panel here.

>go to south
You can't see any such thing.

>south
Main Room
This is the largest room in the station. There is one room to the west and the utility room is to the south. There is a leak in the east wing, so enter with caution.

You can see Aerospace Engineer, a warning sign and a picture frame here.

>examine utility room
You can't see any such thing.

>examine warning sign
DO NOT ENTER EAST WING WITHOUT PROPER GEAR. NO OXYGEN!!

>examine picture frame
You see a photo of the ISS and a caption saying, "The ISS was launched in November 20, 1998."

>examine aerospace engineer
He knows a thing or two about about this space station.

>talk to engineer
"Do you know how to fix the leak in the east wing?" you ask.

"I know the tools you need to fix it. You need to be quick though," he replies. 

 You say, "What do I need to fix the leak?"

"You need a screws and bolts, and some tape."

>go to utility room
You can't see any such thing.

>s
You have to open the door from the control center.

>n
Control Center
There's a control panel alongside the wall. It controls everything that occurs in the space station. The main room is to the south.

You can see Commander and a control panel here.

>examine control panel
You see knobs, buttons, screens, and a bunch of flickering lights. You aren't sure what anything does.

>talk to commander
You must supply a noun.

>examine commaner
You can't see any such thing.

>push button
you pushed the button and heard a click.

* * *

>s
Main Room
This is the largest room in the station. There is one room to the west and the utility room is to the south. There is a leak in the east wing, so enter with caution.

You can see Aerospace Engineer, a warning sign and a picture frame here.

>s
Utility Room
This is where all the tools are kept. The main room is to the north.

You can see a toolbox (closed) here.

>open toolbox
You open the toolbox, revealing Screws.

>take screws
Taken.

>close toolbox
You close the toolbox.

>n
Main Room
This is the largest room in the station. There is one room to the west and the utility room is to the south. There is a leak in the east wing, so enter with caution.

You can see Aerospace Engineer, a warning sign and a picture frame here.

>w
West Wing
There is nothing much here ... except the commander's locker. Perhaps you should take a closer look at it. The main room is to the east.

You can see a locker (closed) here.

>s
You can't go that way.

>n
You can't go that way.

>w
You can't go that way.

>open locker
It seems to be locked.

>examine locker
This is the commander's locker. Enter the six-digit pin code to unlock it.

Please enter the six-digit locker pin code.

>112098
**BUZZ**  Access granted

* * *

>open locker
You open the locker, revealing Bolts, Duct tape and Astronaut suit.

>take bolts and duct tape and astronaut suit
Bolts: Taken.
Duct tape: Taken.
Astronaut suit: Taken.

>e
Main Room
This is the largest room in the station. There is one room to the west and the utility room is to the south. There is a leak in the east wing, so enter with caution.

You can see Aerospace Engineer, a warning sign and a picture frame here.

* * *

>yes
    *** You gasp for air. The door behind you closes. You die from hypoxia. ***

Would you like to RESTART, RESTORE a saved game, QUIT or UNDO the last command?

>undo
Main Room
[Previous turn undone.]

>put on astronaut suit
You put on Astronaut suit.

>e
Are you sure you want to enter?

>yes
You open the door to the east wing. A sudden burst of cold air rushes through your body.

East Wing
There is a crack on the wall and the oxygenation tank has malfunctioned. There's a metal panel on the floor that should be on the tank. The oxygen level is critical. Repair the damage immediately!

You can see a metal panel, a wall and an oxygenation tank here.

>take oxygenation tank
That's fixed in place.

You will soon run out of air. Hurry up!

>use screws and bolts
That's not a verb I recognise.

>put screws on tank
You carefully place all the screws in the right place.

You will soon run out of air. Hurry up!

>put bolts on tank
The bolts are now secured on the tank.

You will soon run out of air. Hurry up!

>fix crack on the wall
That's not a verb I recognise.

>take metal panel
Taken.

You will soon run out of air. Hurry up!

>place metal panel on window
That's not a verb I recognise.

>place metal panel on the wall
That's not a verb I recognise.

>put metal panel on wall
You put the metal panel on the wall.

You will soon run out of air. Hurry up!

>i
You are carrying:
  Astronaut suit (being worn)
  Duct tape

You will soon run out of air. Hurry up!

>duct tape metal panel on wall
That's not a verb I recognise.

>put duct tape on metal panel
Putting things on the metal panel would achieve nothing.

You will soon run out of air. Hurry up!

>take metal panel off of wall
You can't see any such thing.

>remove metal panel from wall
Taken.

You will soon run out of air. Hurry up!

>put duct tape on wall
You put the duct tape over the crack on the wall. Luckily you had just enough to cover the crack.

You will soon run out of air. Hurry up!

>put metal panel on tank
You set the panel on the tank, and it fits perfectly. You hear the oxygenation tank running. You fixed the oxygentation tank.

You will soon run out of air. Hurry up!

    *** Despite your lack of knowledge about the space station, you were able to save everyone onboard from dying of suffocation. Good Job! ***

Would you like to RESTART, RESTORE a saved game, QUIT or UNDO the last command?

>undo
East Wing
[Previous turn undone.]

>put duct tape on wall
(first taking Duct tape)
Why would you want to do that? The duct tape is covering the crack quite nicely and you have other things to do, so get on with it, already!

You will soon run out of air. Hurry up!

>i
You are carrying:
  a metal panel
  Astronaut suit (being worn)

You will soon run out of air. Hurry up!

>put metal panel on tank
You set the panel on the tank, and it fits perfectly. You hear the oxygenation tank running. You fixed the oxygentation tank.

You will soon run out of air. Hurry up!

    *** Despite your lack of knowledge about the space station, you were able to save everyone onboard from dying of suffocation. Good Job! ***

Would you like to RESTART, RESTORE a saved game, QUIT or UNDO the last command?

* * *

A minature meteorite just collided with the east wing! There's a major fracture in the wall as well as several malfunctions in the oxygenating system. The east wing has been temporarily sealed off, but you must repair it or all the oxygen will escape.

Oxygen Breach
An Interactive Fiction by tendo19
Release 1 / Serial number 190304 / Inform 7 build 6M62 (I6/v6.33 lib 6/12N) SD

Control Center
There's a control panel alongside the wall. It controls everything that occurs in the space station. The main room is to the south.

You can see Commander and a control panel here.

>n
You can't go that way.

I beg your pardon?

>e
You can't go that way.

* * *

>s
Main Room
This is the largest room in the station. There is one room to the west and the utility room is to the south. There is a leak in the east wing, so enter with caution.

You can see Aerospace Engineer, a warning sign and a picture frame here.

>w
West Wing
There is nothing much here ... except the commander's locker. The main room is to the east.

You can see a locker (closed) here.

>x locker
This is the commander's locker. Enter the six-digit pin code to unlock it.

Please enter the six-digit locker pin code.

>112089
Incorrect pin, locker remains locked.

Would you like to try again? (Yes or No)

>yes
Please enter the six-digit locker pin code.

>112098
**BUZZ**  Access granted

* * *

>open locker
You open the locker, revealing Bolts, Duct tape and Astronaut suit.

>take astronaut suit
Taken.

* * *

>e
Main Room
This is the largest room in the station. There is one room to the west and the utility room is to the south. There is a leak in the east wing, so enter with caution.

You can see Aerospace Engineer, a warning sign and a picture frame here.

>e
The oxygen level is critical. Repair the damage immediately!

* * *

>n
You can't go that way.

>s
Main Room
...

You can see Aerospace Engineer here.

>ask engineer about the leak
"I know the tools you need to fix it. You need to be quick though," he says.

* * *

>s
Main Room
...

You can see Aerospace Engineer here.

>s
Utility Room
...

>n
Main Room
...

>w
West Wing
...

>e
Main Room
...

>e
East Wing
...

>s
You can't go that way.

>w
Main Room
...

* * *

A minature meteorite just collided with the east wing! There's a major fracture in the wall as well as several malfunctions in the oxygenating system. The east wing has been temporarily sealed off, but you must repair it or all the oxygen will escape.

Oxygen Breach
An Interactive Fiction by tendo19
Release 1 / Serial number 190304 / Inform 7 build 6M62 (I6/v6.33 lib 6/12N) SD

Control Center
There's a control panel alongside the wall. It controls everything that occurs in the space station. The main room is to the south.

You can see Commander and a control panel here.

>push button
you pushed the button and heard a click.

* * *

>w
West Wing
There is nothing much here ... except the commander's locker. Perhaps you should take a closer look at it. The main room is to the east.

You can see a locker (closed) here.

>x locker
This is the commander's locker. Enter the six-digit pin code to unlock it.

Please enter the six-digit locker pin code.

* * *

>yes
You open the door to the east wing. A sudden burst of cold air rushes through your body.

East Wing
There is a crack on the wall and the oxygenation tank has malfunctioned. There's a metal panel on the floor that should be on the tank. The oxygen level is critical. Repair the damage immediately!

You can see a metal panel, a wall and an oxygenation tank here.

>x crack
 There is a huge crack that must be covered. There has to be some way to repair this ... or we will all die.

* * *

>open toolbox
You open the toolbox, revealing Screws.

>take all
Screws: Taken.

>n
Main Room
This is the largest room in the station. There is one room to the west and the utility room is to the south. There is a leak in the east wing, so enter with caution.

You can see Aerospace Engineer, a warning sign and a picture frame here.

* * *

>open locker
You open the locker, revealing Bolts, Duct tape and Astronaut suit.

>take all
Bolts: Taken.
Duct tape: Taken.
Astronaut suit: Taken.

>wear astronaut suit
You put on Astronaut suit.

* * *

>yes
You open the door to the east wing. A sudden burst of cold air rushes through your body.

East Wing
There is a crack on the wall and the oxygenation tank has malfunctioned. There's a metal panel on the floor that should be on the tank. The oxygen level is critical. Repair the damage immediately!

You can see a metal panel, a wall and an oxygenation tank here.

>put duct tape on wall
You put the duct tape over the crack on the wall. Luckily you had just enough to cover the crack.

>put screws on tank
You carefully place all the screws in the right place.

>take metal panel
Taken.

Astronaut Suit Oxygen Level: 90%

>put panel on tank
You need to put both the screws and the bolts on the tank first.

>put bolts on tank
The bolts are now secured on the tank.

>put panel on tank
You set the panel on the tank, and it fits perfectly. You hear the oxygenation tank running. You fixed the oxygentation tank.

Astronaut Suit Oxygen Level: 60%

    *** Despite your lack of knowledge about the space station, you were able to save everyone onboard from dying of suffocation. Good Job! ***

Would you like to RESTART, RESTORE a saved game, QUIT or UNDO the last command?

* * *

>s
Main Room
This is the largest room in the station. There is one room to the west and the utility room is to the south. There is a leak in the east wing, so enter with caution.

You can see Aerospace Engineer, a warning sign and a picture frame here.

>w
West Wing
There is nothing much here ... except the commander's locker. Perhaps you should take a closer look at it. The main room is to the east.

You can see a locker (closed) here.

>e
Main Room
This is the largest room in the station. There is one room to the west and the utility room is to the south. There is a leak in the east wing, so enter with caution.

You can see Aerospace Engineer, a warning sign and a picture frame here.

>x frame
You see a photo of the ISS and a caption saying, "The ISS was launched in November 20, 1998."

>s
Utility Room
This is where all the tools are kept. The main room is to the north.

You can see a toolbox (closed) here.

* * *

>open toolbox
You open the toolbox, revealing Screws.

>get screws
Taken.

>n
Main Room
This is the largest room in the station. There is one room to the west and the utility room is to the south. There is a leak in the east wing, so enter with caution.

You can see Aerospace Engineer, a warning sign and a picture frame here.

>e
    *** You gasp for air. The door behind you closes. You die from hypoxia. ***

Would you like to RESTART, RESTORE a saved game, QUIT or UNDO the last command?

>restart
A minature meteorite just collided with the east wing! There's a major fracture in the wall as well as several malfunctions in the oxygenating system. The east wing has been temporarily sealed off, but you must repair it or all the oxygen will escape.

Oxygen Breach
An Interactive Fiction by tendo19
Release 1 / Serial number 190228 / Inform 7 build 6M62 (I6/v6.33 lib 6/12N) SD

Control Center
There's a control panel alongside the wall. It controls everything that occurs in the space station. The main room is to the south.

You can see Commander and a control panel here.

>push button
you pushed the button and heard a click.

* * *

>open locker
You open the locker, revealing Bolts, Duct tape and Astronaut suit.

>get duct tape
Taken.

>get bolts
Taken.

>get astronaut suit
Taken.

>put on astronaut suit
You put on Astronaut suit.

>e
Main Room
This is the largest room in the station. There is one room to the west and the utility room is to the south. There is a leak in the east wing, so enter with caution.

You can see Aerospace Engineer, a warning sign and a picture frame here.

* * *

>e
The oxygen level is critical. Repair the damage immediately!

>put duct tape on crack
You can't see any such thing.

>use duct tape
That's not a verb I recognise.

>put duct tape on leak
You can't see any such thing.

>put screws on leak
You can't see any such thing.

>put bolts on leak
You can't see any such thing.

>i
You are carrying:
  Astronaut suit (being worn)
  Bolts
  Duct tape
  Screws

>use screws
That's not a verb I recognise.

>put tape on wall
You put the duct tape over the crack on the wall. Luckily you had just enough to cover the crack.

>put duct tape on wall
You put the duct tape over the crack on the wall. Luckily you had just enough to cover the crack.

>put duct tape on wall
You put the duct tape over the crack on the wall. Luckily you had just enough to cover the crack.

>duct tape wall
That's not a verb I recognise.

>e
You can't go that way.

>e
You can't go that way.

>w
Main Room
This is the largest room in the station. There is one room to the west and the utility room is to the south. There is a leak in the east wing, so enter with caution.

You can see Aerospace Engineer, a warning sign and a picture frame here.

>e
The oxygen level is critical. Repair the damage immediately!

>e
You can't go that way.

>fix leak
That's not a verb I recognise.

>put duct tape on wall
You put the duct tape over the crack on the wall. Luckily you had just enough to cover the crack.

>x room
You can't see any such thing.

>look around
You can't see any such thing.

>look
East Wing
...

You can see a metal panel, a wall and an oxygenation tank here.

>e
You can't go that way.

>put duct tape on wall
You put the duct tape over the crack on the wall. Luckily you had just enough to cover the crack.

>look
East Wing
...

You can see a metal panel, a wall and an oxygenation tank here.

>put duct tape on wall
You put the duct tape over the crack on the wall. Luckily you had just enough to cover the crack.

>take metal panel
Taken.

>put metal panel on wall
You put the metal panel on the wall.

>put screws on metal panel
Putting things on the metal panel would achieve nothing.

>x oxygenation tank
The impact of the meteorite must have caused it to malfunction.  There are some loose components ... they must be put back together.

>put screws on oxygenation tank
You put Screws on the oxygenation tank.

>put bolts on oxygenation tank
You put Bolts on the oxygenation tank.

>put duct tape on metal panel
Putting things on the metal panel would achieve nothing.

>w
Main Room
This is the largest room in the station. There is one room to the west and the utility room is to the south. There is a leak in the east wing, so enter with caution.

You can see Aerospace Engineer, a warning sign and a picture frame here.

* * *

>e
You can't go that way.

>put duct tape
What do you want to put Duct tape in?

>wall
That can't contain things.

>put duct tape on wall
You put the duct tape over the crack on the wall. Luckily you had just enough to cover the crack.

>i
You are carrying:
  Astronaut suit (being worn)
  Duct tape

>take metal panel
Taken.

>put metal panel on oxygenation tank
You put the metal panel on the oxygenation tank.

>put duct tape on wall
You put the duct tape over the crack on the wall. Luckily you had just enough to cover the crack.

* * *

>i
You are carrying:
  Astronaut suit (being worn)
  Duct tape

>look
East Wing
...

You can see a wall and an oxygenation tank (on which are a metal panel, Bolts and Screws) here.

* * *

>open locker
You open the locker, revealing Bolts, Duct tape and Astronaut suit.

>take astronaut suit and duct tape
Astronaut suit: Taken.
Duct tape: Taken.

>e
Main Room
This is the largest room in the station. There is one room to the west and the utility room is to the south. There is a leak in the east wing, so enter with caution.

You can see Aerospace Engineer, a warning sign and a picture frame here.

>s
Utility Room
This is where all the tools are kept. The main room is to the north.

You can see a toolbox (closed) here.

* * *

>open toolbox
You open the toolbox, revealing Screws.

>take screes
You can't see any such thing.

>oops screws
Taken.

>n
Main Room
This is the largest room in the station. There is one room to the west and the utility room is to the south. There is a leak in the east wing, so enter with caution.

You can see Aerospace Engineer, a warning sign and a picture frame here.

>e
Are you sure you want to enter?

* * *

>undo
Main Room
[Previous turn undone.]

>wear suit
You put on Astronaut suit.

>e
Are you sure you want to enter?

* * *

>take metal panel
Taken.

>put metal panel on tank
You put the metal panel on the oxygenation tank.

    *** Despite your lack of knowledge about the space station, you were able to save everyone onboard from dying of suffocation. Good Job! ***

Would you like to RESTART, RESTORE a saved game, QUIT or UNDO the last command?

>undo
East Wing
[Previous turn undone.]

* * *

A minature meteorite just collided with the east wing! There's a major fracture in the wall as well as several malfunctions in the oxygenating system. The east wing has been temporarily sealed off, but you must repair it or all the oxygen will escape.

Oxygen Breach
An Interactive Fiction by tendo19
Release 1 / Serial number 190304 / Inform 7 build 6M62 (I6/v6.33 lib 6/12N) SD

Control Center
There's a control panel alongside the wall. It controls everything that occurs in the space station. The main room is to the south.

You can see Commander and a control panel here.

>s
Main Room
This is the largest room in the station. There is one room to the west and the utility room is to the south. There is a leak in the east wing, so enter with caution.

You can see Aerospace Engineer, a warning sign and a picture frame here.

>ask engineer
(for Aerospace Engineer)
(Aerospace Engineer first taking Aerospace Engineer)
Aerospace Engineer has better things to do.

>talk to engineer
That's not a verb I recognise.

* * *

>s
Main Room
This is the largest room in the station. There is one room to the west and the utility room is to the south. There is a leak in the east wing, so enter with caution.

You can see Aerospace Engineer, a warning sign and a picture frame here.

>ask the aerospace engineer
What do you want to ask Aerospace Engineer for?

>the leak
You can't see any such thing.

>leak
That's not a verb I recognise.

>oops leak
That's not a verb I recognise.

* * *

>no
After using good judgement, you determine that it's not safe to enter a room with no oxygen.

I beg your pardon?

>w
You have to open the door from the control center.

>n
Control Center
There's a control panel alongside the wall. It controls everything that occurs in the space station. The main room is to the south.

You can see Commander and a control panel here.

* * *

>open toolbox
You open the toolbox, revealing Screws.

>take screw
You can't see any such thing.

>take screws
Taken.

>n
Main Room
This is the largest room in the station. There is one room to the west and the utility room is to the south. There is a leak in the east wing, so enter with caution.

You can see Aerospace Engineer, a warning sign and a picture frame here.

* * *

>yes
There is a crack on the wall and the oxygenation tank has malfunctioned. There's a metal panel on the floor that should be on the tank. The oxygen level is critical. Repair the damage immediately!

>x room
You can't see any such thing.

>x metal panel
You can't see any such thing.

>x
What do you want to examine?

>room
You can't see any such thing.

>x east wing
I only understood you as far as wanting to examine east.

>x east
You see nothing unexpected in that direction.

>e
Are you sure you want to enter?

>restart
A minature meteorite just collided with the east wing! There's a major fracture in the wall as well as several malfunctions in the oxygenating system. The east wing has been temporarily sealed off, but you must repair it or all the oxygen will escape.

Oxygen Breach
An Interactive Fiction by tendo19
Release 1 / Serial number 190228 / Inform 7 build 6M62 (I6/v6.33 lib 6/12N) SD

Control Center
There's a control panel alongside the wall. It controls everything that occurs in the space station. The main room is to the south.

You can see Commander and a control panel here.

>x control panel
It's covered with knobs, buttons, screens, and a bunch of flickering lights. You aren't sure what anything does.

>talk to commander
You must supply a noun.

>talk to a commander
"Hey, how are you?" you say.

"I'm panicking!!," he replies. 

 You say, "How do I fix the leak?"

"Don't ask me!."

>talk to the commander
"Hey, how are you?" you say.

"I'm panicking!!," he replies. 

 You say, "How do I fix the leak?"

"Don't ask me!."

>talk to commander
You must supply a noun.

>s
Main Room
This is the largest room in the station. There is one room to the west and the utility room is to the south. There is a leak in the east wing, so enter with caution.

You can see Aerospace Engineer, a warning sign and a picture frame here.

>talk to engineer
"Do you know how to fix the leak in the east wing?" you ask.

"I know the tools you need to fix it. You need to be quick though," he replies. 

 You say, "What do I need to fix the leak?"

"You need a screws and bolts, and some tape."

>s
You have to open the door from the control center.

>e
    *** You gasp for air. The door behind you closes. You die from hypoxia. ***

Would you like to RESTART, RESTORE a saved game, QUIT or UNDO the last command?

* * *

>e
Are you sure you want to enter?

>yes
You gasp for air. The door behind you closes. You die from hypoxia.

I beg your pardon?

>purloin astronaut suit
[Purloined.]

>e
Are you sure you want to enter?

>wear suit
Please answer yes or no.

>no
After using good judgement, you determine that it's not safe to enter a room with no oxygen.

>wear astronaut suit
You put on Astronaut suit.

>e
Are you sure you want to enter?

>yes
The oxygen level is critical. Repair the damage immediately!

* * *

>s
Main Room
This is the largest room in the station. There is one room to the west and the utility room is to the south. There is a leak in the east wing, so enter with caution.

You can see Aerospace Engineer, a warning sign and a picture frame here.

>n
Control Center
There's a control panel alongside the wall. It controls everything that occurs in the space station.

You can see Commander and a control panel here.

>s
Main Room
This is the largest room in the station. There is one room to the west and the utility room is to the south. There is a leak in the east wing, so enter with caution.

You can see Aerospace Engineer, a warning sign, a picture frame and Button here.

>e
    *** You gasp for air. The door behind you closes. You die from hypoxia. ***

Would you like to RESTART, RESTORE a saved game, QUIT or UNDO the last command?

>s
Please give one of the answers above.

Would you like to RESTART, RESTORE a saved game, QUIT or UNDO the last command?

>restart
A minature meteorite just collided with the east wing! There's a major fracture in the wall as well as several malfunctions in the oxygenating system. The east wing has been temporarily sealed off, but you must repair it or all the oxygen will escape.

Oxygen Breach
An Interactive Fiction by tendo19
Release 1 / Serial number 190228 / Inform 7 build 6M62 (I6/v6.33 lib 6/12N) SD

Control Center
There's a control panel alongside the wall. It controls everything that occurs in the space station.

You can see Commander and a control panel here.

>s
Main Room
This is the largest room in the station. There is one room to the west and the utility room is to the south. There is a leak in the east wing, so enter with caution.

You can see Aerospace Engineer, a warning sign, a picture frame and Button here.

>s
You have to push the button first.

* * *

>s
Main Room
This is the largest room in the station. There is one room to the west and the utility room is to the south. There is a leak in the east wing, so enter with caution.

You can see Aerospace Engineer, a warning sign and a picture frame here.

>s
Utility Room
...

You can see a toolbox (closed) here.

>n
Main Room
...

You can see Aerospace Engineer, a warning sign and a picture frame here.

>w
West Wing
...

You can see a locker (closed) here.

>e
You gasp for air. The door behind you closes. You die from hypoxia.

* * *

>s
Main Room
This is the largest room in the station. There is one room to the west and the utility room is to the south. There is a leak in the east wing, so enter with caution.

You can see Aerospace Engineer, a warning sign and a picture frame here.

>talk to aerospace engineer
"Do you know how to fix the leak in the east wing?" you ask

"I know the tools you need to fix it. You need to be quick though," he replies, 
 you comment, "What do I need to fix the leak?"

"You need a screws and bolts, and some tape."

>x enginerr
You can't see any such thing.

>x engineer
...

* * *

>s
Main Room
This is the largest room in the station. There is one room to the west and the utility room is to the south. There is a leak in the east wing, so enter with caution.

You can see Aerospace Engineer, a warning sign and a picture frame here.

>talk to engineer
I didn't understand that sentence.

>erer
That's not a verb I recognise.

* * *

>talk to engineer
I didn't understand that sentence.

>talk to aerospace engineer
You must supply a noun.

* * *

>talk to engineer
I didn't understand that sentence.

>talking to engineer
That's not a verb I recognise.

>talk to aerospace engineer
You must supply a noun.

* * *

>s
Main Room
This is the largest room in the station. There is one room to the west and the utility room is to the south. There is a leak in the east wing, so enter with caution.

You can see Aerospace Engineer, a warning sign and a picture frame here.

>w
West Wing
...

You can see a locker (closed) here.

>open locker
It seems to be locked.

>x locker
This is the commander's locker. Enter the six-digit pin code to unlock it.

Please enter the six-digit locker pin code.

>112098
That's not a verb I recognise.

Please enter the six-digit locker pin code.

>112098
That's not a verb I recognise.

Please enter the six-digit locker pin code.

* * *

>w
West Wing
...

You can see a locker (closed) here.

>x locker
This is the commander's locker. Enter the six-digit pin code to unlock it.

Please enter the six-digit locker pin code.

>1120
That's not a verb I recognise.

Please enter the six-digit locker pin code.

>12
That's not a verb I recognise.

Please enter the six-digit locker pin code.

>12
That's not a verb I recognise.

Please enter the six-digit locker pin code.

>1
That's not a verb I recognise.

Please enter the six-digit locker pin code.

>21
That's not a verb I recognise.

Please enter the six-digit locker pin code.

>2
That's not a verb I recognise.

Please enter the six-digit locker pin code.

>12
That's not a verb I recognise.

Please enter the six-digit locker pin code.

* * *

>1
That's not a verb I recognise.

Please enter the six-digit locker pin code.

>23
That's not a verb I recognise.

Please enter the six-digit locker pin code.

>4
That's not a verb I recognise.

Please enter the six-digit locker pin code.

I beg your pardon?

Please enter the six-digit locker pin code.

>23
That's not a verb I recognise.

Please enter the six-digit locker pin code.

>423
That's not a verb I recognise.

Please enter the six-digit locker pin code.

>4121
That's not a verb I recognise.

Please enter the six-digit locker pin code.

>21
That's not a verb I recognise.

Please enter the six-digit locker pin code.

>21
That's not a verb I recognise.

Please enter the six-digit locker pin code.

>221212
That's not a verb I recognise.

Please enter the six-digit locker pin code.

* * *

>112098
**BUZZ**  Access granted

>112098
That's not a verb I recognise.

Please enter the six-digit locker pin code.

>121212
That's not a verb I recognise.

Please enter the six-digit locker pin code.

* * *

>112098
**BUZZ**  Access granted

>oepn lcoker
That's not a verb I recognise.

* * *

>x locker
This is the commander's locker. Enter the six-digit pin code to unlock it.

Please enter the six-digit locker pin code.

>1234
**BUZZ**  Access granted

>open locker
You open the Locker.

* * *

>x locker
This is the commander's locker. Enter the six-digit pin code to unlock it.

Please enter the six-digit locker pin code.

>AAAA
That's not a verb I recognise.

Please enter the six-digit locker pin code.

>dedede
That's not a verb I recognise.

Please enter the six-digit locker pin code.

* * *

>x locker
This is the commander's locker. Enter the six-digit pin code to unlock it.

Please enter the six-digit locker pin code.

>open locker
It seems to be locked.

>enter pin code
You can't see any such thing.

* * *

>w
West Wing
...

You can see a locker (closed) here.

>x lockr
You can't see any such thing.

>x locker
This is the commander's locker. Enter the six-digit pin code to unlock it.

Please enter the six-digit locker pin code.

>123212
That's not a verb I recognise.

Please enter the six-digit locker pin code.

>1234
That's not a verb I recognise.

Please enter the six-digit locker pin code.

* * *

A minature meteorite just collided with the east wing! There's a major fracture in the wall as well as several malfunctions in the oxygenating system. The east wing has been temporarily sealed off, but you must repair it or all the oxygen will escape.

Oxygen Breach
An Interactive Fiction by tendo19
Release 1 / Serial number 190304 / Inform 7 build 6M62 (I6/v6.33 lib 6/12N) SD

Control Center
There's a control panel alongside the wall. It controls everything that occurs in the space station. The main room is to the south.

You can see Commander and a control panel here.

>talk to commander
You must supply a noun.

* * *

>s
Main Room
This is the largest room in the station. There is one room to the west and the utility room is to the south. There is a leak in the east wing, so enter with caution.

You can see Aerospace Engineer, a warning sign and a picture frame here.

>talk to aerospace engineer
"Do you know how to fix the leak in the east wing?" you ask, "I know the tools you need to fix it. You need to be quick though," he replies, you comment, "What do I need to fix the leak?" "You need a wrench, screws and bolts, and a hammer."

* * *

>talk to commander
You must supply a noun.

>talk to the commander
"Hey, how are you?" you say.

"I'm panicking!!," he replies. 

 You say, "How do I fix the leak?"

"Don't ask me!."

* * *

A minature meteorite just collided with the east wing! There's a major fracture in the wall as well as several malfunctions in the oxygenating system. The east wing has been temporarily sealed off, but you must repair it or all the oxygen will escape.

Oxygen Breach
An Interactive Fiction by tendo19
Release 1 / Serial number 190304 / Inform 7 build 6M62 (I6/v6.33 lib 6/12N) SD

Control Center
There's a control panel alongside the wall. It controls everything that occurs in the space station. The main room is to the south.

You can see Commander and a control panel here.

>talk to the commander
"Hey, how are you?" you say.

"I'm panicking!!," he replies. 

 You say, "What do I need to fix the leak?"

"Don't ask me!."

* * *

A minature meteorite just collided with the east wing! There's a major fracture in the wall as well as several malfunctions in the oxygenating system. The east wing has been temporarily sealed off, but you must repair it or all the oxygen will escape.

Oxygen Breach
An Interactive Fiction by tendo19
Release 1 / Serial number 190304 / Inform 7 build 6M62 (I6/v6.33 lib 6/12N) SD

Control Center
There's a control panel alongside the wall. It controls everything that occurs in the space station. The main room is to the south.

You can see Commander and a control panel here.

>x commander
This is the guy in charge. He probably knows a thing or two about this place.

>x control panel
You see knobs, buttons, screens, and a bunch of flickering lights. You aren't sure what anything does.

>ask commander about this place
There is no reply.

>n
You can't go that way.

>s
Main Room
This is the largest room in the station. There is one room to the west and the utility room is to the south. There is a leak in the east wing, so enter with caution.

You can see Aerospace Engineer, a warning sign and a picture frame here.

>x aerospace engineer
He specializes in engineering and knowing about spaceships.

>ask aerospace engineer about spaceships
There is no reply.

>x warning sign
DO NOT ENTER EAST WING WITHOUT PROPER GEAR. NO OXYGEN!!

>x picture frame
You see a photo of the ISS and a caption saying, "The ISS was launched in November 20, 1998."

>w
You have to open the door from the control center.

>open door
You can't see any such thing.

>s
You have to open the door from the control center.

* * *

>x control panel
You see knobs, buttons, screens, and a bunch of flickering lights. You aren't sure what anything does.

>x screens
You can't see any such thing.

>x knobs
You can't see any such thing.

>x buttons
You can't see any such thing.

>open door
You can't see any such thing.

>push buttons
You can't see any such thing.

>push button
you pushed the button and heard a click.

* * *

>s
Utility Room
This is where all the tools are kept. The main room is to the north.

You can see a toolbox (closed) here.

>x toolbox
A heavy container full of useful tools.

>open toolbox
You open the toolbox, revealing Screws.

* * *

>take screws
Taken.

>i
You are carrying:
  Screws

>n
Main Room
This is the largest room in the station. There is one room to the west and the utility room is to the south. There is a leak in the east wing, so enter with caution.

You can see Aerospace Engineer, a warning sign and a picture frame here.

>talk to aerospace engineer
"Do you know how to fix the leak in the east wing?" you ask.

"I know the tools you need to fix it. You need to be quick though," he replies. 

 You say, "What do I need to fix the leak?"

"You need a screws and bolts, and some tape."

>e
    *** You gasp for air. The door behind you closes. You die from hypoxia. ***

Would you like to RESTART, RESTORE a saved game, QUIT or UNDO the last command?

* * *

>restart
A minature meteorite just collided with the east wing! There's a major fracture in the wall as well as several malfunctions in the oxygenating system. The east wing has been temporarily sealed off, but you must repair it or all the oxygen will escape.

Oxygen Breach
An Interactive Fiction by tendo19
Release 1 / Serial number 190228 / Inform 7 build 6M62 (I6/v6.33 lib 6/12N) SD

Control Center
There's a control panel alongside the wall. It controls everything that occurs in the space station. The main room is to the south.

You can see Commander and a control panel here.

>x control panel
You see knobs, buttons, screens, and a bunch of flickering lights. You aren't sure what anything does.

* * *

>w
West Wing
There is nothing much here ... except the commander's locker. The main room is to the east.

You can see a locker (closed) here.

>open locker
It seems to be locked.

>unlock locker
(with the locker)
(first taking the locker)
That's fixed in place.

>e
    *** You gasp for air. The door behind you closes. You die from hypoxia. ***

Would you like to RESTART, RESTORE a saved game, QUIT or UNDO the last command?

* * *

>s
Main Room
This is the largest room in the station. There is one room to the west and the utility room is to the south. There is a leak in the east wing, so enter with caution.

You can see Aerospace Engineer, a warning sign and a picture frame here.

>x sign
DO NOT ENTER EAST WING WITHOUT PROPER GEAR. NO OXYGEN!!

>s
Utility Room
This is where all the tools are kept. The main room is to the north.

You can see a toolbox (closed) here.

* * *

>n
Main Room
This is the largest room in the station. There is one room to the west and the utility room is to the south. There is a leak in the east wing, so enter with caution.

You can see Aerospace Engineer, a warning sign and a picture frame here.

>x sign
DO NOT ENTER EAST WING WITHOUT PROPER GEAR. NO OXYGEN!!

>x frame
You see a photo of the ISS and a caption saying, "The ISS was launched in November 20, 1998."

>x frame
You see a photo of the ISS and a caption saying, "The ISS was launched in November 20, 1998."

>z
Time passes.

>z
Time passes.

>w
West Wing
There is nothing much here ... except the commander's locker. The main room is to the east.

You can see a locker (closed) here.

* * *

>x locker
This is the commander's locker. Enter the six-digit pin code to unlock it.

Please enter the six-digit locker pin code.

>666666
Incorrect pin, locker remains locked.

Would you like to try again? (Yes or No)

* * *

>n
You can't go that way.

>s
You can't go that way.

>se
You can't go that way.

>sw
You can't go that way.

>e
    *** You gasp for air. The door behind you closes. You die from hypoxia. ***

Would you like to RESTART, RESTORE a saved game, QUIT or UNDO the last command?

* * *

A minature meteorite just collided with the east wing! There's a major fracture in the wall as well as several malfunctions in the oxygenating system. The east wing has been temporarily sealed off, but you must repair it or all the oxygen will escape.

Oxygen Breach
An Interactive Fiction by tendo19
Release 1 / Serial number 190304 / Inform 7 build 6M62 (I6/v6.33 lib 6/12N) SD

Control Center
There's a control panel alongside the wall. It controls everything that occurs in the space station. The main room is to the south.

You can see Commander and a control panel here.

>x control panel
You see knobs, buttons, screens, and a bunch of flickering lights. You aren't sure what anything does.

* * *

>push button
you pushed the button and heard a click.

>push button
Stop button mashing and get on with your mission.

>s
Main Room
This is the largest room in the station. There is one room to the west and the utility room is to the south. There is a leak in the east wing, so enter with caution.

You can see Aerospace Engineer, a warning sign and a picture frame here.

* * *

>x control panel
You see knobs, buttons, screens, and a bunch of flickering lights. You aren't sure what anything does.

>x commander
This is the guy in charge. He probably knows a thing or two about this place.

>talk to commander
You must supply a noun.

* * *

>talk to the commander
"Hey, how are you?" you say.

"I'm panicking!!," he replies. 

 You say, "How do I fix the leak?"

"Don't ask me!."

>s
Main Room
This is the largest room in the station. There is one room to the west and the utility room is to the south. There is a leak in the east wing, so enter with caution.

You can see Aerospace Engineer, a warning sign and a picture frame here.

* * *

>x sign
DO NOT ENTER EAST WING WITHOUT PROPER GEAR. NO OXYGEN!!

>talk to the engineer
"Do you know how to fix the leak in the east wing?" you ask.

"I know the tools you need to fix it. You need to be quick though," he replies. 

 You say, "What do I need to fix the leak?"

"You need a screws and bolts, and some tape."

>s
Access denied: go to control center to gain access.

>n
Control Center
There's a control panel alongside the wall. It controls everything that occurs in the space station. The main room is to the south.

You can see Commander and a control panel here.

>n
You can't go that way.

>use control panel
That's not a verb I recognise.

>x control panel
You see knobs, buttons, screens, and a bunch of flickering lights. You aren't sure what anything does.

* * *

>push button
you pushed the button and heard a click.

I beg your pardon?

>s
Main Room
This is the largest room in the station. There is one room to the west and the utility room is to the south. There is a leak in the east wing, so enter with caution.

You can see Aerospace Engineer, a warning sign and a picture frame here.

* * *

>x locker
This is the commander's locker. Enter the six-digit pin code to unlock it.

Please enter the six-digit locker pin code.

>e
Incorrect pin, locker remains locked.

Would you like to try again? (Yes or No)

* * *

>e
Main Room
This is the largest room in the station. There is one room to the west and the utility room is to the south. There is a leak in the east wing, so enter with caution.

You can see Aerospace Engineer, a warning sign and a picture frame here.

>n
Control Center
There's a control panel alongside the wall. It controls everything that occurs in the space station. The main room is to the south.

You can see Commander and a control panel here.

>talk to the commander
"Hey, how are you?" you say.

"I'm panicking!!," he replies. 

 You say, "How do I fix the leak?"

"Don't ask me!."

* * *

>s
Main Room
This is the largest room in the station. There is one room to the west and the utility room is to the south. There is a leak in the east wing, so enter with caution.

You can see Aerospace Engineer, a warning sign and a picture frame here.

>x picture
You see a photo of the ISS and a caption saying, "The ISS was launched in November 20, 1998."

>w
West Wing
There is nothing much here ... except the commander's locker. Perhaps you should take a closer look at it. The main room is to the east.

You can see a locker (closed) here.

>open locker
It seems to be locked.

* * *

>take all
Bolts: Taken.
Duct tape: Taken.
Astronaut suit: Taken.

>put on suit
You put on Astronaut suit.

>e
Main Room
This is the largest room in the station. There is one room to the west and the utility room is to the south. There is a leak in the east wing, so enter with caution.

You can see Aerospace Engineer, a warning sign and a picture frame here.

>talk to the engineer
"Do you know how to fix the leak in the east wing?" you ask.

"I know the tools you need to fix it. You need to be quick though," he replies. 

 You say, "What do I need to fix the leak?"

"You need a screws and bolts, and some tape."

>e
Are you sure you want to enter?

* * *

>yes
You open the door to the east wing. A sudden burst of cold air rushes through your body.

East Wing
There is a crack on the wall and the oxygenation tank has malfunctioned. There's a metal panel on the floor that should be on the tank. The oxygen level is critical. Repair the damage immediately!

You can see a metal panel, a wall and an oxygenation tank here.

>fix
That's not a verb I recognise.

>fix crack
That's not a verb I recognise.

>repair the oxygen tank
That's not a verb I recognise.

>put tape on crac
You can't see any such thing.

>put tape on crack
You put the duct tape over the crack on the wall. Luckily you had just enough to cover the crack.

>put the panel on the tank
You need to put both the screws and the bolts on the tank first.

>put screws on takn
You can't see any such thing.

>put screws on tank
You carefully place all the screws in the right place.

Astronaut Suit Oxygen Level: 90%

>put bolts on tank
The bolts are now secured on the tank.

Astronaut Suit Oxygen Level: 90%

>put pannel on tank
You can't see any such thing.

>take all
metal panel: Taken.
Duct tape: Why would you want to do that? The duct tape is covering the crack quite nicely and you have other things to do, so get on with it, already!
Bolts: Taken.
Screws: Taken.

Astronaut Suit Oxygen Level: 90%

>put bolts on tank
The bolts are now secured on the tank.

Astronaut Suit Oxygen Level: 90%Astronaut Suit Oxygen Level: 60%

>put screws on tank
You carefully place all the screws in the right place.

Astronaut Suit Oxygen Level: 90%Astronaut Suit Oxygen Level: 60%

>put panel on tank
You set the panel on the tank, and it fits perfectly. You hear the oxygenation tank running. You fixed the oxygentation tank.

Astronaut Suit Oxygen Level: 90%Astronaut Suit Oxygen Level: 60%

    *** Despite your lack of knowledge about the space station, you were able to save everyone onboard from dying of suffocation. Good Job! ***

Would you like to RESTART, RESTORE a saved game, QUIT or UNDO the last command?